.CCCCCC...CCCCCC.
.CAAAAA...AAAAAC.
.CA...........AC.
.CA...........AC.
.CA.BB.....BB.AC.
.CA.BB.....BB.AC.
.CA...........AC.
.CA....CCC....AC.
.CA..WWWWWWW..AC.
.CA..WWWWWWW..AC.
.CA....CCC....AC.
.CA...........AC.
.CA.BB.....BB.AC.
.CA.BB.....BB.AC.
.CA...........AC.
.CA...........AC.
.CAAAAA...AAAAAC.
.CCCCCC...CCCCCC.