.................
BBBBBBBBBBBBBBBBB
A...............A
A...............A
A...............A
A...............A
AAAA.........AAAA
A..A....A....A..A
A..A...A.A...A..A
A..A...A.A...A..A
A..A...A.A...A..A
A..A....A....A..A
AAAA.........AAAA
A...............A
A...............A
A...............A
A...............A
BBBBBBBBBBBBBBBBB
.................