.................
CCCCCCC...CCCCCCC
C..A..C...C..A..C
C..A..C...C..A..C
C..A..C...C..A..C
C..A..C...C..A..C
C...............C
C...............C
C.BBB..WWW..BBB.C
C.BBB..WWW..BBB.C
C...............C
C...............C
C..A..C...C..A..C
C..A..C...C..A..C
C..A..C...C..A..C
C..A..C...C..A..C
CCCCCCC...CCCCCCC
.................