.................
.................
.................
WW....C...C....WW
W....C.....C....W
....C..B.B..C....
...C..B...B..C...
..C..B.....B..C..
.C..B..AAA..B..C.
C..B...ACA...B..C
.C..B..AAA..B..C.
..C..B.....B..C..
...C..B...B..C...
....C..B.B..C....
W....C.....C....W
WW....C...C....WW
.................
.................