.................
CC..CC..CCCCCC.CC
CC..CC..CCCCCC.CC
CC..CC..CC..CC.CC
CC..CC..CC..CC.CC
CC..CC..CC..CC.CC
CC..CC..CC..CC.CC
CC..CC..CC..CC.CC
CCCCCC..CCCCCC.CC
CCCCCC..CCCCCC.CC
CC..CC..CC.....CC
CC..CC..CC.....CC
CC..CC..CC.....CC
CC..CC..CC.....CC
CC..CC..CC.....CC
CC..CC..CC.....CC
CC..CC..CC.....CC
.................