.................
.C..WWWWWWWWWWWWW
.C..............W
.CCCCCCCCCCCCC..W
.C...........C..W
.CCCCCCCCCCCCC..W
.C..............W
.C..CCCCCCCCCCCCW
.C..............W
.CCCCCCCCCCCCC..W
.C..............W
.C..CCCCCCCCCCCCW
.C..............W
.CCCCCCCCCCCCC..W
.C..............W
.C..CCCCCCCCCCCCW
.C..............W
.................