.................
...A.........A...
..AAA.......AAA..
.AABAA.....AABAA.
..AAA...A...AAA..
...A...AAA...A...
......AACAA......
...A...AAA...A...
..AAA...A...AAA..
.AAWAA.....AAWAA.
..AAA...A...AAA..
...A...AAA...A...
......AACAA......
...A...AAA...A...
..AAA...A...AAA..
.AABAA.....AABAA.
..AAA.......AAA..
...A.........A...