CCCCCCCC.CCCCCCCC
CCCCCCCC.CCCCCCCC
CC.............CC
CC...AAAAAAA...CC
CC...A.....A...CC
CC...AAAAAAA...CC
CC...A.........CC
CC...A.........CC
CCCCCC.....CCCCCC
CCCCCC.....CCCCCC
CC.............CC
CC...BBBBB.....CC
CC...B....B....CC
CC...B.....B...CC
CC...B.....B...CC
CC...B.....B...CC
CC...B....B....CC
CC...BBBBB.....CC