.C..C..BBBB..AAA.
.C..C..B..B..AAA.
.C..C..B..B..AAA.
.CCCC..BBBB..AAA.
.C..C..B.....AAA.
.C..C..B.....AAA.
CCCCCCCCCCCCCCCCC
.CBBBBBBBBBBBBBC.
..CBAAAAAAAAABC..
...CBAAAAAAABC...
....CBAAAAABC....
.....CBAAABC.....
......CBABC......
....C..CBC..C....
...CBC..C..CBC...
..CBABC...CBABC..
.CBBBBBC.CBBBBBC.
CCCCCCCCCCCCCCCCC