.................
.....CCCCCCC.....
....CC.....CC....
...CC..BBB..CC...
..CC..BAAAB..CC..
.CC..BBBBBBB..CC.
.C.............C.
.CBCCCCCCCCCCCBC.
.C.....A.A.....C.
.C.BBB.A.A.BBB.C.
.C.BAB.C.C.BAB.C.
.C.BAB.C.C.BAB.C.
.C.BAB.C.C.BAB.C.
.C.BAB.C.C.BAB.C.
.C.BAB.C.C.BAB.C.
.C.BBB.C.C.BBB.C.
.C.....C.C.....C.
.CCCCCCC.CCCCCCC.