..A...........A..
.AAA.........AAA.
AWAWA.......AWAWA
AAWAA.......AAWAA
ACCCA.......ACCCA
.ACA..AAAAA..ACA.
..A...AACAA...A..
..A...ACCCA...A..
..A.A.AACAA.A.A..
.AAA..AAAAA..AAA.
A.A...AAAAA...A.A
..A...AACAA...A..
..A...ACCCA...A..
..A...ACCCA...A..
..A...ACCCA...A..
.A.A..AACAA..A.A.
.A.A..AAAAA..A.A.
A...A.......A...A
A...A.......A...A