.................
........A........
.......AAA.......
......AABAA......
.....AABBBAA.....
....AABBBBBAA....
...AABCCCCCBAA...
..AABB.....BBAA..
.ACCBB.WWW.BBCCA.
.ACCBB.WWW.BBCCA.
..AABB.....BBAA..
...AABCCCCCBAA...
....AABBBBBAA....
.....AABBBAA.....
......AABAA......
.......AAA.......
........A........
.................