.................
AAAAW.WWWWW.WAAAA
AAAW...WWW...WAAA
AAW..B..W..B..WAA
AW..BCB.W.BCB..WA
WWW..B..W..B..WWW
WW.B...W.W...B.WW
W...WWW...WWW...W
..B..A..B..A..B..
.BCB.A.BCB.A.BCB.
..B..W..B..W..B..
W...W.W...W.W...W
WW.B...WWW...B.WW
WWW..B..W..B..WWW
AW..BCB.W.BCB..WA
AAW..B..W..B..WAA
AAAW...WWW...WAAA
AAAAW.WWWWW.WAAAA
.................