.................
.................
.WWW.........WWW.
.WC...........CW.
.W.............W.
.................
........A........
......WAWAW......
.....A.....A.....
......WAWAW......
........A........
.................
.................
.W.............W.
.WC...........CW.
.WWW.........WWW.
.................
.................