..A...........A..
.ABA.........ABA.
ABWBA.......ABWBA
.ABA..WCWCW..ABA.
..A..WCCCCCW..A..
....WCBBBBBCW....
...WACBBBBBCAW...
..WA.ACBBBCA.AW..
.WA...ACBCA...AW.
WA.....ACA.....AW
.WA...ACBCA...AW.
..WA.ACBBBCA.AW..
...WACBBBBBCAW...
....WCBBBBBCW....
..A..WCCCCCW..A..
.AWA..WCWCW..AWA.
..A...........A..
.................