.................
.................
..AA...CCC...AA..
..AA...CCC...AA..
.AAAA.......AAAA.
.AAAA.......AAAA.
AAAAAA.....AAAAAA
AAAAAA.....AAAAAA
BBBBBBBBBBBBBBBBB
BBBBBBBBBBBBBBBBB
AAAAAA.....AAAAAA
AAAAAA.....AAAAAA
.AAAA.......AAAA.
.AAAA.......AAAA.
..AA...CCC...AA..
..AA...CCC...AA..
.................
.................