.................
.................
...........AAAAA.
...........AAAAA.
...........AA....
.CCCCCCCCCCAAAAA.
.CCCCCCCCCCAAAAA.
...........AA....
...........AAAAA.
...........AAAAA.
.................
.................
.................
.CCCCCCCCAAAAAAA.
.CCCCCCCCAAAAAAA.
.........AAAAAA..
...........AAA...
.................