........W........
.......WWW.......
......WWWWW......
.....WWWWWWWW....
......WWWWWWW....
......AAAAA......
.....AAAAAAA.....
.....AABABAA.....
....AAABABAAA....
....AAAAAAAAA....
...AAAAABAAAAA...
...AAAAAAAAAAA...
....AACAAACAA....
....AACCCCCAA....
.....AAACAAA.....
.....AAAAAAA.....
......AAAAA......
......AAAAA......
.......AAA.......