.................
.CC...........CC.
.CC...........CC.
........A........
.......AAA.......
......AAAAA......
B....AAAAAAA....B
B...AAAAAAAAA...B
WWWWWWWWWWWWWWWWW
WWWWWWWWWWWWWWWWW
B...AAAAAAAAA...B
B....AAAAAAA....B
......AAAAA......
.......AAA.......
........A........
.CC...........CC.
.CC...........CC.
.................