.................
.WW...........WW.
.WWW.........WWW.
.W.W.........W.W.
.W.............W.
.W.............W.
.W.............W.
.W.............W.
.W.BBB.....BBB.W.
.W.B.B.....B.B.W.
.WB...B...B...BW.
.WB...B...B...BW.
.B.....BCB.....B.
.B.....BCB.....B.
..B...B...B...B..
..B...B...B...B..
...B.B.....B.B...
...BBB.....BBB...